"filename", "language", "C++", "Java", "JSON", "comment", "blank", "total"
"e:\ww\ccccppppppppppp\binary_tree.cpp", "C++", 0, 0, 0, 0, 2, 2
"e:\ww\ccccppppppppppp\haash.cpp", "C++", 0, 0, 0, 0, 1, 1
"e:\ww\ccccppppppppppp\javaaaaa\FrontMiddleBackQueue.java", "Java", 0, 128, 0, 0, 29, 157
"e:\ww\ccccppppppppppp\javaaaaa\RBTree.java", "Java", 0, 309, 0, 234, 31, 574
"e:\ww\ccccppppppppppp\javaaaaa\RBTreev2.java", "Java", 0, 305, 0, 23, 21, 349
"e:\ww\ccccppppppppppp\javaaaaa\SelectSort.java", "Java", 0, 0, 0, 0, 2, 2
"e:\ww\ccccppppppppppp\javaaaaa\binarySearch.java", "Java", 0, 38, 0, 2, 4, 44
"e:\ww\ccccppppppppppp\javaaaaa\magic.class", "Java", 0, 15, 0, 0, 0, 15
"e:\ww\ccccppppppppppp\javaaaaa\magic.java", "Java", 0, 119, 0, 11, 13, 143
"e:\ww\ccccppppppppppp\mobi.cpp", "C++", 67, 0, 0, 14, 3, 84
"e:\ww\ccccppppppppppp\openSourceCodetips\nginx_roundup.cpp", "C++", 13, 0, 0, 65, 16, 94
"e:\ww\ccccppppppppppp\recu.cpp", "C++", 0, 0, 0, 0, 5, 5
"e:\ww\ccccppppppppppp\rust\mystack\target\.rustc_info.json", "JSON", 0, 0, -1, 0, 0, -1
"e:\ww\ccccppppppppppp\rust\mystack\target\debug\.fingerprint\mystack-17ead9b6a3c367ea\lib-mystack.json", "JSON", 0, 0, -1, 0, 0, -1
"e:\ww\ccccppppppppppp\rust\mystack\target\debug\.fingerprint\mystack-24cfd96fdea32d79\test-lib-mystack.json", "JSON", 0, 0, -1, 0, 0, -1
"e:\ww\ccccppppppppppp\rust\mystack\target\debug\.fingerprint\mystack-35542c1baf6f5b95\bin-mystack.json", "JSON", 0, 0, -1, 0, 0, -1
"e:\ww\ccccppppppppppp\rust\mystack\target\debug\.fingerprint\mystack-801ca8dd335713bf\test-bin-mystack.json", "JSON", 0, 0, -1, 0, 0, -1
"e:\ww\ccccppppppppppp\rust\mystack\target\debug\.fingerprint\mystack-8809621481184532\test-lib-mystack.json", "JSON", 0, 0, -1, 0, 0, -1
"e:\ww\ccccppppppppppp\rust\mystack\target\debug\.fingerprint\mystack-93070214b6202210\lib-mystack.json", "JSON", 0, 0, -1, 0, 0, -1
"e:\ww\ccccppppppppppp\rust\mystack\target\debug\.fingerprint\mystack-97f5a12640f1853e\test-bin-mystack.json", "JSON", 0, 0, -1, 0, 0, -1
"e:\ww\ccccppppppppppp\rust\mystack\target\debug\.fingerprint\mystack-eaa43719bcf9b9bc\bin-mystack.json", "JSON", 0, 0, -1, 0, 0, -1
"e:\ww\ccccppppppppppp\rust\mystack\target\debug\.fingerprint\mystack-fa3b3de84a855cb7\test-bin-mystack.json", "JSON", 0, 0, -1, 0, 0, -1
"e:\ww\ccccppppppppppp\rust\mystack\target\debug\.fingerprint\mystack-ffed88e9ea78de1d\test-bin-mystack.json", "JSON", 0, 0, -1, 0, 0, -1
"e:\ww\ccccppppppppppp\serializeTree.cpp", "C++", 147, 0, 0, 15, 3, 165
"Total", "-", 227, 914, -11, 364, 130, 1624