"filename", "language", "Java", "C++", "Markdown", "JSON", "Rust", "comment", "blank", "total"
"e:\ww\ccccppppppppppp\binary_search.cpp", "C++", 0, 85, 0, 0, 0, 1, -1, 85
"e:\ww\ccccppppppppppp\binary_tree.cpp", "C++", 0, 73, 0, 0, 0, 0, 0, 73
"e:\ww\ccccppppppppppp\javaaaaa\MyCircularQueue.java", "Java", 42, 0, 0, 0, 0, 0, 9, 51
"e:\ww\ccccppppppppppp\javaaaaa\MyCircularQueueV2node.java", "Java", 51, 0, 0, 0, 0, 0, 12, 63
"e:\ww\ccccppppppppppp\javaaaaa\list.java", "Java", 18, 0, 0, 0, 0, 27, 7, 52
"e:\ww\ccccppppppppppp\rust\.VSCodeCounter\2022-09-30_18-17-30\details.md", "Markdown", 0, 0, 17, 0, 0, 0, 6, 23
"e:\ww\ccccppppppppppp\rust\.VSCodeCounter\2022-09-30_18-17-30\diff-details.md", "Markdown", 0, 0, 9, 0, 0, 0, 6, 15
"e:\ww\ccccppppppppppp\rust\.VSCodeCounter\2022-09-30_18-17-30\diff.md", "Markdown", 0, 0, 12, 0, 0, 0, 7, 19
"e:\ww\ccccppppppppppp\rust\.VSCodeCounter\2022-09-30_18-17-30\results.json", "JSON", 0, 0, 0, 1, 0, 0, 0, 1
"e:\ww\ccccppppppppppp\rust\.VSCodeCounter\2022-09-30_18-17-30\results.md", "Markdown", 0, 0, 25, 0, 0, 0, 7, 32
"e:\ww\ccccppppppppppp\rust\mystack\src\graph_al.rs", "Rust", 0, 0, 0, 0, 20, 0, 2, 22
"e:\ww\ccccppppppppppp\rust\mystack\src\lib.rs", "Rust", 0, 0, 0, 0, 327, 2, 12, 341
"e:\ww\ccccppppppppppp\rust\mystack\src\sort_alg.rs", "Rust", 0, 0, 0, 0, 327, 2, 14, 343
"e:\ww\ccccppppppppppp\rust\mystack\target\.rustc_info.json", "JSON", 0, 0, 0, 1, 0, 0, 0, 1
"e:\ww\ccccppppppppppp\rust\mystack\target\debug\.fingerprint\mystack-17ead9b6a3c367ea\lib-mystack.json", "JSON", 0, 0, 0, 1, 0, 0, 0, 1
"e:\ww\ccccppppppppppp\rust\mystack\target\debug\.fingerprint\mystack-24cfd96fdea32d79\test-lib-mystack.json", "JSON", 0, 0, 0, 1, 0, 0, 0, 1
"e:\ww\ccccppppppppppp\rust\mystack\target\debug\.fingerprint\mystack-35542c1baf6f5b95\bin-mystack.json", "JSON", 0, 0, 0, 1, 0, 0, 0, 1
"e:\ww\ccccppppppppppp\rust\mystack\target\debug\.fingerprint\mystack-801ca8dd335713bf\test-bin-mystack.json", "JSON", 0, 0, 0, 1, 0, 0, 0, 1
"e:\ww\ccccppppppppppp\rust\mystack\target\debug\.fingerprint\mystack-8809621481184532\test-lib-mystack.json", "JSON", 0, 0, 0, 1, 0, 0, 0, 1
"e:\ww\ccccppppppppppp\rust\mystack\target\debug\.fingerprint\mystack-93070214b6202210\lib-mystack.json", "JSON", 0, 0, 0, 1, 0, 0, 0, 1
"e:\ww\ccccppppppppppp\rust\mystack\target\debug\.fingerprint\mystack-97f5a12640f1853e\test-bin-mystack.json", "JSON", 0, 0, 0, 1, 0, 0, 0, 1
"e:\ww\ccccppppppppppp\rust\mystack\target\debug\.fingerprint\mystack-eaa43719bcf9b9bc\bin-mystack.json", "JSON", 0, 0, 0, 1, 0, 0, 0, 1
"e:\ww\ccccppppppppppp\rust\mystack\target\debug\.fingerprint\mystack-fa3b3de84a855cb7\test-bin-mystack.json", "JSON", 0, 0, 0, 1, 0, 0, 0, 1
"e:\ww\ccccppppppppppp\rust\mystack\target\debug\.fingerprint\mystack-ffed88e9ea78de1d\test-bin-mystack.json", "JSON", 0, 0, 0, 1, 0, 0, 0, 1
"Total", "-", 111, 158, 63, 12, 674, 32, 81, 1131